abierto - open
abundante - abundant
aburrido - boring
activo - active
afligido - afflicted
agradable - agreeable
agradecido - grateful
alegre - joyous
altivo - haughty
alto - tall, high
alumbrado - lit(up)
amable - friendly
amorfo - amorphous
analógico - analog
anciano - elderly
angélico - angelic
angosto - narrow
anterior - previous
antiguo - antique
antipático - mean, not nice
antiséptico - antiseptic
aparte - apart
apenas - barely
apestoso - stinky
aplicable - applicable
apreciativo - appreciative
apropiado - apppropriate
apto - apt
árido - arid
astuto - artful
asombroso - astonishing
aterrador - apalling
atlético - athletic
atrevido - bold
ausente - absent
azulado - bluish
bajo - short (height)
barato - cheap
bárbaro - barbarous
bellísimo - very beautiful
bello - beautiful
bendito - blessed
bienvenido - welcome
bilingüe - bilingual
bonito - pretty
borroso - blurry
boyante - buoyant
brumoso - foggy
bruto - brutal
bueno - good
caliente - hot
calloso - callous
carnal - carnal
cansado - tired
caprichoso - quirky
carbólico - carbolic
cardíaco - cardiac
cardinal - cardinal
carísimo - very expensive
caro - expensive
4
centenario - centennial
central - central
cerámico - ceramic
ceremonial - ceremonial
ceremonioso - ceremonious
cerrado - closed
cíclico - cyclical
cívico - civic
civilizado - civilized
claro - clear
clásico - classic
combustible - combustible
cómico - comical
cómodo - comfortable
confundido - confused
conocido - known
contento - content
cortés - courteous
corto - short (length)
correcto - correct
cuidadoso - careful
chapado - plated
chango - playful
charlador - talkative
chico - small
chiflado - loco
chiquito - tiny
chismoso - gossipy
chistoso - funny
chocante - offensive
chulo - cute
crespo - curly
débil - weak
decente - decent
delgado - thin
delicioso - delicious
desconocido - unkown
descortés - discourteous
descubierto - uncovered
despreciable - despicable
destituido - destitute
destructible - destructible
desvanecido - dissipated
diestro - clever
difícil - difficult
digestible - digestible
digestivo - digestive
digital - digital
digno - dignified
divertido - entertaining
divino - divine
dócil - docile
dogmático - dogmatic
dominante - dominant
dulce - sweet
dúctil - ductile
duro - hard
ecléctico - eclectic
económico - economic
editorial - editorial
educado - educated
eficaz - effective
5
efímero - ephemeral
efusivo - effusive
egotista - egotistical
ejecutivo - executive
ejemplar - exemplary
elegante - elegant
elemental - elementary
elevado - elevated
elíptico - elliptic
elocuente - eloquent
elusivo - elusive
embarazada - pregnant
embarazoso - troublesome
emocionante - exciting
emotivo - emotive
encallecido - calloused
encantado - enchanted
encerado - waxed
encerrado - caged, jailed
endémico - endemic
enérgico - energetic
enfermo - sick
enorme - enormous
envidiable - enviable
envidioso - envious
errado - wrong
escamoso - scaly
escaso - scarce
escéptico - skeptic
escrito - written
espantado - scared
espantoso - scary
especial - special
espeso - spicy
estupendo - stupendous
eventual - eventual
evidente - evident
excelente - excellent
experto - expert
exponencial - exponential
exquisito - exquisite
extátcio - ecstatic
extensivo - extensive
extra - extra
extranjero - foreign
extremo - extreme
fabuloso - fabulous
falso - false
famoso - famous
familiar - familiar
fanático - fanatic
fantástico - fantastic
fastidioso - fastidious
fasto - auspicious
fatal - fatal
favorito - favorite
fecho - executed(law)
federal - federal
femenino - feminine
fenomenal - phenomenal
feliz - happy
feo - ugly
6
fértil - fertile
ferveroso - fervent
férreo - iron
feudal - fuedal
fiel - loyal
figurado - figurative
fílmico - film
financiero - financial
flagrante - flagrant
flexible - flexible
flojo - loose
folklórico - folkloric
fónico - phonic
formidable - formidable
franco - frank
frío - cold
frito - fried
frívolo - frivolous
fuerte - strong
fundido - melted
gallardo - gallant
gastado - worn-out
gelatinoso - gelatinous
genérico - generic
generoso - generous
genético - genetic
genio - genius
gentil - gentile
genuino - genuine
geológico - geological
geriátrico - geriatric
glorioso - glorious
glotón - gluttonous
gordo - fat
gradado - stepped
gran - grand
grande - big
grandote - very big
granoso - grainy
grasoso - greasy
grave - serious
grosero - rude
guapo - handsome
hábil - skilled
hablado - spoken
halagüeño - flattering
hambriento - hungry
hediondo - stinky
helado - frozen
hermético - airtight
hermoso - beautiful
hilarante - hilarious
histórico - historical
honesto - honest
horrible - horrible
horrífico - horrific
huesudo - bony
humano - human
húmedo - humid
ignorante - ignorant
ilegal - illegal
ilegible - illegible
7
ilógico - illogical
iluminado - illuminated
ilustrado - illustrated
imaginario - imaginary
impaciente - impatient
impar - uneven, odd
impenetrable - impenetrable
imperdonable - inexcusable
imparcial - impartial
importante - important
improviso - unexpected
imprudente - imprudent
inalámbrico - wireless
inatento - unattentive
incalculable - incalculable
incoherente - incoherent
incomestible - inedible
incómodo - uncomfortable
incomparable - incomparable
incompatible - incompatible
incompetente - incompetant
incompleto - incomplete
inconveniente - inconvenient
incorrecto - incorrect
incorregible - incorrigible
incorruptible - incorruptible
incrédulo - incredulous
indebido - improper
indefinido - undefined
indecente - indecent
indígena - native
indigno - unworthy
indivisible - indivisible
inédito - unpublished
infantil - childish
infeccioso - infectious
infiel - faithless
injusto - unjust
insensato - insane
inteligente - intelligent
interesante - interesting
inquieto - active(hyper)
invisible - invisible
irritable - irritable
jabonoso - soapy
jactancioso - boastful
joven - young
jovial - jovial
jubilado - retired
judicial - judicial
juguetón - playful
juicioso - wise
juntos - together
jurado - sworn
justificable - justifiable
justificante - justifying
justo - just
juvenil - youthful
labrado - wrought
lacio - limp
ladino - wise
lamentable - lamentable
8
largo - long
larguísimo - very long
larval - larval
latoso - bothersome
lavable - washable
lejano - far away
lento - slow
libre - free
libre de cuidado - carefree
limpio - clean
liso - smooth
listo - smart, ready
liviano - light
lívido - livid
loco - crazy
lodoso - muddy
lógico - logical
lúcido - lucid
luminoso - luminous
lunático - lunatic
llamativo - showy
llameante - flaming
llano - flat ground
lleno - full
llorón - crying
lloroso - tearful
lluvioso - rainy
maduro - ripe
magnánimo - magnamonious
magnético - magnetic
magnífico - magnificent
majestuoso - majestic
maligno - evil
malo - bad
malsano - unhealthy
malvado - wicked
mandón - bossy
manejable - manageable
manuscrito - hand written
marchito - withered
mareado - seasick
marino - marine
matoso - bushy
mayor - older
mejor - better
menor - younger
mímico - mimic
mínimo - minimal
mismo - same
mojado - wet
moreno - dark-haired
mucho - many
mudable - changeable
muerto - dead
musical - musical
nebuloso - hazy
necesario - necessary
novato - newbie
nublado - cloudy
nuevo - new
ocupado - busy
optimista - optimist(ic)
9
paciente - patient
pagadero - payable
pagado - paid
parado - standing(up)
paralelo - parallel
parásito - parasitic
parecido - alike
parejo - even, smooth
particular - particular
pasado - by gone
pasajero - fleeting
pastoral - pastoral
paternal - fatherly
patológico - pathological
patriótico - patriotic
pecoso - freckled
pedagógico - pedagogic
pedestre - pedestrian
pegajoso - sticky
pelado - peeled
peligroso - dangerous
pelirrojo - red-haired
peludo - hairy
penado - afflicted
pendiente - pending
penoso - shameful
pensativo - pensive
peñascoso - rocky
pequeño - small
percudido - grimy
perecedero - passing
perezoso - lazy
perfecto - perfect
perjudicial - harmful
permanente - permanent
persuasivo - persuasive
pesado - heavy
pésimo - very bad
piadoso - pious
picante - spicy
pintoresco - picturesque
plácido - placid
plano - flat, plane
plumoso - feathery
pobre - poor
pocos - few
podrido - rotten
poético - poetic
policíaco - police related
pomposo - pompous
popular - popular
precavido - cautious
preferido - preferred
preocupado - worried
preparado - prepared
presente - present
primero - first
privado - private
privilegiado - privileged
profético - prophetic
puro - pure
quebrado - broken
10
quemado - burnt
querido - dear
quieto - quiet, still
quincenal - bimonthly
rabioso - rabid
radial - radial
rancio - rancid
rápido - rapid
razonable - reasonable
rebelde - rebellious
rebosante - overflowing
recargable - rechargeable
receloso - distrustful
receptivo - receptive
reciclable - recyclable
reciente - recent
recojido - secluded
reconocido - recognized
recurrente - recurring
redundante - redundant
reemplazable - replaceable
refinado - refined
repugnante - repugnant
resonante - resonant
rico - rich
ridículo - ridiculous
robusto - robust
romántico - romantic
ronco - hoarse
roñoso - mangy
rubio - blond
sabroso - savory
sagaz - canny
sangriento - bloody
santificado - sanctified
seco - dry
seguro - safe
selecto - select
serio - serious
simpático - nice
sin aliento - breathless
sólido - solid
solo - alone
sólo - only
suave - soft
sucio - dirty
tacaño - stingy
todo - all
tonto - foolish
torcido - twisted
transparente - transparent
triste - sad
umbroso - shady
unánime - unanimous
único - unique, only
ventoso - windy
verdadero - true
valiente - valiant
vacío - empty
varios - variety, varied
viejo - old
vivo - alive